{
  "name": "Classic",
  "author": "PyGuara",
  "grid": [
    "  #####",
    "###   #",
    "#.@$  #",
    "### $.#",
    "#.##$ #",
    "# # . ##",
    "#$  $$.#",
    "#   .  #",
    "########"
  ]
}
